{
  "schema_version": 1,
  "table_id": "zynq_core_board_pin_map.v1_0",
  "interfaces": {
    "ethernet_phy": {
      "pin_count": 10,
      "pins": [
        "X3-1",
        "X3-2",
        "X3-3",
        "X3-4",
        "X3-5",
        "X3-6",
        "X3-7",
        "X3-8",
        "X3-9",
        "X3-10"
      ]
    },
    "ground": {
      "pin_count": 20,
      "pins": [
        "X3-11",
        "X3-12",
        "X3-62",
        "X3-63",
        "X3-76",
        "X3-77",
        "X4-19",
        "X4-34",
        "X4-41",
        "X4-52",
        "X4-59",
        "X4-70",
        "X4-93",
        "X4-94",
        "X4-95",
        "X4-96",
        "X4-97",
        "X4-98",
        "X4-99",
        "X4-100"
      ]
    },
    "jtag": {
      "pin_count": 4,
      "pins": [
        "X3-97",
        "X3-98",
        "X3-99",
        "X3-100"
      ]
    },
    "pl_io": {
      "pin_count": 123,
      "pins": [
        "X3-13",
        "X3-14",
        "X3-15",
        "X3-16",
        "X3-17",
        "X3-18",
        "X3-19",
        "X3-20",
        "X3-21",
        "X3-22",
        "X3-23",
        "X3-24",
        "X3-25",
        "X3-26",
        "X3-27",
        "X3-28",
        "X3-29",
        "X3-30",
        "X3-31",
        "X3-32",
        "X3-33",
        "X3-34",
        "X3-35",
        "X3-36",
        "X3-37",
        "X3-38",
        "X3-39",
        "X3-40",
        "X3-41",
        "X3-42",
        "X3-43",
        "X3-44",
        "X3-45",
        "X3-46",
        "X3-47",
        "X3-48",
        "X3-49",
        "X3-50",
        "X3-51",
        "X3-52",
        "X3-53",
        "X3-54",
        "X3-55",
        "X3-56",
        "X3-57",
        "X3-58",
        "X3-59",
        "X3-60",
        "X3-61",
        "X4-11",
        "X4-12",
        "X4-13",
        "X4-14",
        "X4-15",
        "X4-16",
        "X4-17",
        "X4-18",
        "X4-20",
        "X4-21",
        "X4-22",
        "X4-23",
        "X4-24",
        "X4-25",
        "X4-26",
        "X4-27",
        "X4-28",
        "X4-29",
        "X4-30",
        "X4-31",
        "X4-32",
        "X4-33",
        "X4-35",
        "X4-36",
        "X4-37",
        "X4-38",
        "X4-39",
        "X4-40",
        "X4-42",
        "X4-43",
        "X4-44",
        "X4-45",
        "X4-46",
        "X4-47",
        "X4-48",
        "X4-49",
        "X4-50",
        "X4-51",
        "X4-53",
        "X4-54",
        "X4-55",
        "X4-56",
        "X4-57",
        "X4-58",
        "X4-60",
        "X4-61",
        "X4-62",
        "X4-63",
        "X4-64",
        "X4-65",
        "X4-66",
        "X4-67",
        "X4-68",
        "X4-69",
        "X4-71",
        "X4-72",
        "X4-73",
        "X4-74",
        "X4-75",
        "X4-76",
        "X4-77",
        "X4-78",
        "X4-79",
        "X4-80",
        "X4-81",
        "X4-82",
        "X4-83",
        "X4-84",
        "X4-85",
        "X4-86",
        "X4-87",
        "X4-88",
        "X4-89",
        "X4-90"
      ]
    },
    "power": {
      "pin_count": 8,
      "pins": [
        "X4-1",
        "X4-2",
        "X4-3",
        "X4-4",
        "X4-5",
        "X4-6",
        "X4-7",
        "X4-8"
      ]
    },
    "ps_or_dedicated": {
      "pin_count": 31,
      "pins": [
        "X3-64",
        "X3-65",
        "X3-66",
        "X3-67",
        "X3-68",
        "X3-69",
        "X3-70",
        "X3-71",
        "X3-72",
        "X3-73",
        "X3-74",
        "X3-75",
        "X3-78",
        "X3-79",
        "X3-80",
        "X3-81",
        "X3-82",
        "X3-83",
        "X3-84",
        "X3-85",
        "X3-86",
        "X3-87",
        "X3-88",
        "X3-89",
        "X3-90",
        "X3-91",
        "X3-92",
        "X3-93",
        "X3-94",
        "X3-95",
        "X3-96"
      ]
    },
    "special": {
      "pin_count": 1,
      "pins": [
        "X4-9"
      ]
    },
    "unused": {
      "pin_count": 3,
      "pins": [
        "X4-10",
        "X4-91",
        "X4-92"
      ]
    }
  }
}